36 28
13.25 26.75 13.25 14.75 13.25 17.75 11.25 17.75 15.25 17.75 14 18
10 10 10 10 10 10 10 10 10 10 10 10 10 10 10 10 10 10 10 10 10 10 10 10 10 10 10 10
10 10 10 10 10 10 10 10 10 10 10 10 10 10 10 10 10 10 10 10 10 10 10 10 10 10 10 10
10 10 10 10 10 10 15 18 18 18 18 18 18 18 18 18 18 18 18 18 18 16 10 10 10 10 10 10
10 10 10 10 10 10 19 12 11 11 11 11 11 11 11 11 11 11 11 11 12 20 10 10 10 10 10 10
10 10 10 10 10 10 19 11 23 24 11 23 26 26 26 26 24 11 23 24 11 20 10 10 10 10 10 10
10 10 10 10 10 10 19 11 27 28 11 21 25 24 23 25 22 11 27 28 11 20 10 10 10 10 10 10
10 10 10 10 10 10 19 11 27 28 11 11 11 27 28 11 11 11 27 28 11 20 10 10 10 10 10 10
10 10 10 10 10 10 19 11 27 21 26 24 11 27 28 11 23 26 22 28 11 20 10 10 10 10 10 10
18 18 18 18 18 18 22 11 27 23 25 22 11 21 22 11 21 25 24 28 11 21 18 18 18 18 18 18
10 10 10 11 11 11 11 11 27 28 11 11 11 11 11 11 11 11 27 28 11 11 11 11 11 10 10 10
26 26 24 11 23 26 26 26 22 28 11 23 26 26 26 26 24 11 27 21 26 26 26 24 11 23 26 26
23 25 22 11 21 25 25 25 24 28 11 21 25 24 23 25 22 11 27 23 25 25 25 22 11 21 25 24
27 11 11 11 11 11 11 11 27 28 11 11 11 27 28 11 11 11 27 28 11 11 11 11 11 11 11 28
27 11 23 26 26 26 24 11 27 21 26 24 11 27 28 11 23 26 22 28 11 23 26 26 26 24 11 28
27 11 21 25 25 24 28 11 21 25 25 22 11 21 22 11 21 25 25 22 11 27 23 25 25 22 11 28
27 11 11 11 11 27 28 11 11 10 10 10 10 10 10 10 10 10 10 11 11 27 28 11 11 11 11 28
21 26 26 24 11 27 21 25 24 10 31 17 17 41 41 17 17 32 10 23 26 22 28 11 23 26 26 22
25 25 24 28 11 21 25 25 22 10 20 10 10 10 10 10 10 19 10 21 25 25 22 11 27 23 25 25
10 10 27 28 11 11 11 11 11 10 20 10 10 10 10 10 10 19 10 11 11 11 11 11 27 28 10 10
24 10 21 22 11 23 26 26 24 10 20 10 10 10 10 10 10 19 10 23 26 26 24 11 21 22 10 23
28 10 10 10 11 27 23 25 22 10 29 18 18 18 18 18 18 30 10 21 25 24 28 11 11 11 11 27
28 10 23 24 11 27 28 11 11 10 10 10 10 10 10 10 10 10 10 11 11 27 28 11 23 24 10 27
28 10 27 28 11 27 28 11 23 26 26 26 26 26 26 26 26 26 26 24 11 27 28 11 27 28 10 27
22 10 27 28 11 27 28 11 21 25 25 25 25 24 23 25 25 25 25 22 11 27 28 11 27 28 10 21
10 10 27 28 11 27 28 11 11 11 11 11 11 27 28 11 11 11 11 11 11 27 28 11 27 28 10 10
26 26 22 28 11 27 21 26 26 26 26 24 11 27 28 11 23 26 26 26 26 22 28 11 27 21 26 26
36 25 25 22 11 21 25 25 25 25 25 22 11 21 22 11 21 25 25 25 25 25 22 11 21 25 25 38
19 11 11 11 11 11 11 11 11 11 11 11 11 10 10 11 11 11 11 11 11 11 11 11 11 11 11 20
19 11 23 24 11 23 17 17 17 17 17 17 17 17 17 17 17 17 17 17 17 17 24 11 23 24 11 20
19 11 27 28 11 20 10 10 10 10 10 10 10 10 10 10 10 10 10 10 10 10 19 11 27 28 11 20
19 11 27 28 11 20 10 10 10 10 10 10 10 10 10 10 10 10 10 10 10 10 19 11 27 28 11 20
19 11 21 22 11 20 10 10 10 10 10 10 10 10 10 10 10 10 10 10 10 10 19 11 21 22 11 20
19 12 11 11 11 20 10 10 10 10 10 10 10 10 10 10 10 10 10 10 10 10 19 11 11 11 12 20
13 17 17 17 17 14 10 10 10 10 10 10 10 10 10 10 10 10 10 10 10 10 13 17 17 17 17 14
10 10 10 10 10 10 10 10 10 10 10 10 10 10 10 10 10 10 10 10 10 10 10 10 10 10 10 10
10 10 10 10 10 10 10 10 10 10 10 10 10 10 10 10 10 10 10 10 10 10 10 10 10 10 10 10