36 28
13.25 25.75 13.25 13.75 13.25 16.75 11.25 16.75 15.25 16.75 14 17
10 10 10 10 10 10 10 10 10 10 10 10 10 10 10 10 10 10 10 10 10 10 10 10 10 10 10 10 
10 10 10 10 10 10 10 10 10 10 10 10 10 10 10 10 10 10 10 10 10 10 10 10 10 10 10 10 
10 10 10 10 10 10 10 10 10 10 10 10 10 10 10 10 10 10 10 10 10 10 10 10 10 10 10 10 
15 18 18 18 18 18 18 18 18 18 18 18 18 33 34 18 18 18 18 18 18 18 18 18 18 18 18 16 
19 11 11 11 11 11 11 11 11 11 11 11 11 27 28 11 11 11 11 11 11 11 11 11 11 11 11 20 
19 11 23 26 26 24 11 23 26 26 26 24 11 27 28 11 23 26 26 26 24 11 23 26 26 24 11 20 
19 12 27 42 42 28 11 27 42 42 42 28 11 27 28 11 27 42 42 42 28 11 27 42 42 28 12 20
19 11 21 25 25 22 11 21 25 25 25 22 11 21 22 11 21 25 25 25 22 11 21 25 25 22 11 20 
19 11 11 11 11 11 11 11 11 11 11 11 11 11 11 11 11 11 11 11 11 11 11 11 11 11 11 20 
19 11 23 26 26 24 11 23 24 11 23 26 26 26 26 26 26 24 11 23 24 11 23 26 26 24 11 20 
19 11 21 25 25 22 11 27 28 11 21 25 25 24 23 25 25 22 11 27 28 11 21 25 25 22 11 20 
19 11 11 11 11 11 11 27 28 11 11 11 11 27 28 11 11 11 11 27 28 11 11 11 11 11 11 20 
13 17 17 17 17 24 11 27 21 26 26 24 10 27 28 10 23 26 26 22 28 11 23 17 17 17 17 14 
10 10 10 10 10 19 11 27 23 25 25 22 10 21 22 10 21 25 25 24 28 11 20 10 10 10 10 10 
10 10 10 10 10 19 11 27 28 10 10 10 10 10 10 10 10 10 10 27 28 11 20 10 10 10 10 10 
10 10 10 10 10 19 11 27 28 10 31 17 17 41 41 17 17 32 10 27 28 11 20 10 10 10 10 10
18 18 18 18 18 22 11 21 22 10 20 10 10 10 10 10 10 19 10 21 22 11 21 18 18 18 18 18 
10 10 10 10 10 10 11 10 10 10 20 10 10 10 10 10 10 19 10 10 10 11 10 10 10 10 10 10 
17 17 17 17 17 24 11 23 24 10 20 10 10 10 10 10 10 19 10 23 24 11 23 17 17 17 17 17 
10 10 10 10 10 19 11 27 28 10 29 18 18 18 18 18 18 30 10 27 28 11 20 10 10 10 10 10 
10 10 10 10 10 19 11 27 28 10 10 10 10 10 10 10 10 10 10 27 28 11 20 10 10 10 10 10 
10 10 10 10 10 19 11 27 28 10 23 26 26 26 26 26 26 24 10 27 28 11 20 10 10 10 10 10 
15 18 18 18 18 22 11 21 22 10 21 25 25 24 23 25 25 22 10 21 22 11 21 18 18 18 18 16 
19 11 11 11 11 11 11 11 11 11 11 11 11 27 28 11 11 11 11 11 11 11 11 11 11 11 11 20 
19 11 23 26 26 24 11 23 26 26 26 24 11 27 28 11 23 26 26 26 24 11 23 26 26 24 11 20 
19 11 21 25 24 28 11 21 25 25 25 22 11 21 22 11 21 25 25 25 22 11 27 23 25 22 11 20 
19 12 11 11 27 28 11 11 11 11 11 11 11 10 10 11 11 11 11 11 11 11 27 28 11 11 12 20
35 26 24 11 27 28 11 23 24 11 23 26 26 26 26 26 26 24 11 23 24 11 27 28 11 23 26 37 
36 25 22 11 21 22 11 27 28 11 21 25 25 24 23 25 25 22 11 27 28 11 21 22 11 21 25 38 
19 11 11 11 11 11 11 27 28 11 11 11 11 27 28 11 11 11 11 27 28 11 11 11 11 11 11 20 
19 11 23 26 26 26 26 22 21 26 26 24 11 27 28 11 23 26 26 22 21 26 26 26 26 24 11 20 
19 11 21 25 25 25 25 25 25 25 25 22 11 21 22 11 21 25 25 25 25 25 25 25 25 22 11 20 
19 11 11 11 11 11 11 11 11 11 11 11 11 11 11 11 11 11 11 11 11 11 11 11 11 11 11 20 
13 17 17 17 17 17 17 17 17 17 17 17 17 17 17 17 17 17 17 17 17 17 17 17 17 17 17 14 
10 10 10 10 10 10 10 10 10 10 10 10 10 10 10 10 10 10 10 10 10 10 10 10 10 10 10 10 
10 10 10 10 10 10 10 10 10 10 10 10 10 10 10 10 10 10 10 10 10 10 10 10 10 10 10 10 
