19 26
13.25 14.75 13.25 6.75 13.25 9.75 11.25 9.75 15.25 9.75 14 10
10 10 10 10 10 10 10 10 10 10 10 10 10 10 10 10 10 10 10 10 10 10 10 10 10 10
10 10 10 10 10 10 10 10 10 10 10 10 10 10 10 10 10 10 10 10 10 10 10 10 10 10
10 10 10 10 10 10 10 10 10 10 10 10 10 10 10 10 10 10 10 10 10 10 10 10 10 10
15 18 18 18 18 18 33 34 18 18 18 18 18 18 18 18 18 18 33 34 18 18 18 18 18 16
19 12 11 11 11 11 27 28 11 11 11 11 11 11 11 11 11 11 27 28 11 11 11 11 12 20
19 11 23 26 24 11 27 28 11 23 26 26 26 26 26 26 24 11 27 28 11 23 26 24 11 20
19 11 27 23 22 11 21 22 11 21 25 25 25 25 25 25 22 11 21 22 11 21 24 28 11 20
19 11 27 28 11 11 11 11 11 11 11 11 11 11 11 11 11 11 11 11 11 11 27 28 11 20
19 11 21 22 11 23 26 24 11 31 17 17 41 41 17 17 32 11 23 26 24 11 21 22 11 20
19 11 11 11 11 27 42 28 11 20 10 10 10 10 10 10 19 11 27 42 28 11 11 11 11 20
19 11 23 24 11 27 42 28 11 20 10 10 10 10 10 10 19 11 27 42 28 11 23 24 11 20
19 11 27 28 11 21 25 22 11 29 18 18 18 18 18 18 30 11 21 25 22 11 27 28 11 20
19 11 27 28 11 11 11 11 11 11 11 11 11 11 11 11 11 11 11 11 11 11 27 28 11 20
19 11 27 21 24 11 23 24 11 23 26 26 26 26 26 26 24 11 23 24 11 23 22 28 11 20
19 11 21 25 22 11 27 28 11 21 25 25 25 25 25 25 22 11 27 28 11 21 25 22 11 20
19 11 11 11 11 11 27 28 11 11 11 11 10 10 11 11 11 11 27 28 11 11 11 11 12 20
13 17 17 17 17 17 39 40 17 17 17 17 17 17 17 17 17 17 39 40 17 17 17 17 17 14
10 10 10 10 10 10 10 10 10 10 10 10 10 10 10 10 10 10 10 10 10 10 10 10 10 10
10 10 10 10 10 10 10 10 10 10 10 10 10 10 10 10 10 10 10 10 10 10 10 10 10 10