19 19
8.75 14.75 8.75 6.75 9.75 9.75 6.75 9.75 10.75 9.75 9 10
10 10 10 10 10 10 10 10 10 10 10 10 10 10 10 10 10 10 10
10 10 10 10 10 10 10 10 10 10 10 10 10 10 10 10 10 10 10
10 10 10 10 10 10 10 10 10 10 10 10 10 10 10 10 10 10 10
15 18 18 18 18 18 18 18 18 18 18 18 18 18 18 18 18 18 16
19 11 11 11 11 11 11 11 11 11 11 11 11 11 11 11 11 11 20
19 11 23 26 26 26 26 26 24 11 23 26 26 26 26 26 24 11 20
19 11 27 23 25 25 25 25 22 11 21 25 25 25 25 24 28 11 20
19 11 27 28 12 10 10 10 10 10 10 10 10 10 10 27 28 11 20
19 11 27 28 10 31 17 17 41 41 41 17 17 32 10 27 28 11 20
19 11 27 28 10 20 10 10 10 10 10 10 10 19 10 27 28 11 20
19 11 27 28 10 20 10 10 10 10 10 10 10 19 10 27 28 11 20
19 11 27 28 10 29 18 18 18 18 18 18 18 30 10 27 28 11 20
19 11 27 28 10 10 10 10 10 10 10 10 10 10 12 27 28 11 20
19 11 27 21 26 26 26 26 24 11 23 26 26 26 26 22 28 11 20
19 11 21 25 25 25 25 25 22 11 21 25 25 25 25 25 22 11 20
19 11 11 11 11 11 11 11 10 10 10 11 11 11 11 11 11 11 20
13 17 17 17 17 17 17 17 17 17 17 17 17 17 17 17 17 17 14
10 10 10 10 10 10 10 10 10 10 10 10 10 10 10 10 10 10 10
10 10 10 10 10 10 10 10 10 10 10 10 10 10 10 10 10 10 10
