22 58
35.25 17.75 35.25 6.75 35.25 9.75 33.25 9.75 37.25 9.75 36 10
10 10 10 10 10 10 10 10 10 10 10 10 10 10 10 10 10 10 10 10 10 10 10 10 10 10 10 10 10 10 10 10 10 10 10 10 10 10 10 10 10 10 10 10 10 10 10 10 10 10 10 10 10 10 10 10 10 10
10 10 10 10 10 10 10 10 10 10 10 10 10 10 10 10 10 10 10 10 10 10 10 10 10 10 10 10 10 10 10 10 10 10 10 10 10 10 10 10 10 10 10 10 10 10 10 10 10 10 10 10 10 10 10 10 10 10
10 10 10 10 10 10 10 10 10 10 10 10 10 10 10 10 10 10 10 10 10 10 10 10 10 10 10 10 10 10 10 10 10 10 10 10 10 10 10 10 10 10 10 10 10 10 10 10 10 10 10 10 10 10 10 10 10 10
15 18 18 18 18 18 18 18 18 18 18 18 18 18 18 18 18 18 18 18 18 18 18 18 18 18 18 18 18 18 18 18 18 18 18 18 18 18 18 18 18 18 18 18 18 18 18 18 18 18 18 18 18 18 18 18 18 16
19 11 11 11 11 11 11 11 11 11 11 11 11 11 11 11 11 11 11 11 11 11 11 11 11 11 11 11 11 11 11 11 11 11 11 11 11 11 11 11 11 11 11 11 11 11 11 11 11 11 11 11 11 11 11 11 11 20
19 11 23 26 24 11 23 26 26 26 26 26 26 26 24 11 23 26 26 26 26 26 26 26 26 26 26 26 26 26 24 11 23 26 26 26 26 26 26 24 11 23 26 26 26 26 26 26 26 26 26 24 11 23 26 24 11 20
19 12 21 25 22 11 27 10 10 10 10 10 10 10 28 11 21 25 25 25 25 25 25 25 25 25 25 25 25 25 22 10 21 25 25 25 25 25 25 22 10 28 10 10 10 10 10 10 10 10 10 27 11 21 25 22 12 20
19 11 11 11 11 11 27 10 23 26 26 26 26 26 22 11 11 11 11 11 11 11 11 11 11 11 11 11 11 11 10 10 10 10 10 10 10 10 10 10 10 28 10 23 25 25 25 25 25 24 10 27 11 11 11 11 11 20
13 17 17 17 24 11 27 10 27 11 11 11 11 11 11 11 23 26 24 11 23 26 24 11 23 26 26 26 26 26 24 10 31 17 17 41 41 17 17 32 10 28 10 27 11 11 11 11 11 28 10 27 11 23 17 17 17 14
10 10 10 10 19 11 27 10 27 11 23 26 26 26 24 11 28 10 27 11 28 10 27 11 28 10 10 10 10 10 27 10 20 10 10 10 10 10 10 19 10 28 10 27 11 23 26 24 11 28 10 27 11 20 10 10 10 10
18 18 18 18 22 11 21 25 22 11 27 10 10 10 27 11 28 10 27 11 28 10 27 11 21 25 25 25 25 25 22 10 20 10 10 10 10 10 10 19 10 21 25 22 11 28 10 27 11 21 25 22 11 21 18 18 18 18
10 10 10 10 10 11 11 11 11 12 27 10 10 10 27 11 28 10 27 11 28 10 27 11 11 11 11 11 11 11 10 10 20 10 10 10 10 10 10 19 10 10 11 11 11 28 10 27 11 11 11 11 11 10 10 10 10 10
17 17 17 17 24 11 23 26 24 11 27 10 10 10 27 11 28 10 27 11 28 10 27 11 23 26 26 26 26 26 24 10 29 18 18 18 18 18 18 30 10 23 26 26 26 22 10 21 26 26 26 24 11 23 17 17 17 17
10 10 10 10 19 11 27 10 28 11 27 10 10 10 27 11 28 10 27 11 28 10 27 11 28 10 10 10 10 10 27 10 10 10 10 10 10 10 10 10 10 28 10 10 10 10 10 10 10 10 10 27 11 20 10 10 10 10
15 18 18 18 22 11 21 25 22 11 21 25 25 25 22 11 21 25 22 11 21 25 22 11 21 25 25 25 25 25 22 10 23 25 25 25 25 25 25 24 10 21 25 25 25 25 25 25 25 25 25 22 11 21 18 18 18 16
19 11 11 11 11 11 11 11 11 11 11 11 11 11 11 11 11 11 11 11 11 11 11 11 11 11 11 11 11 11 11 11 21 26 26 24 23 26 26 22 11 11 11 11 11 11 11 11 11 11 11 11 11 11 11 11 11 20
19 11 23 26 26 24 11 23 26 26 26 26 26 26 26 26 24 11 23 24 11 23 26 26 26 26 26 26 26 26 24 11 11 11 11 27 28 11 11 11 11 23 26 26 26 26 26 26 26 24 11 23 26 26 26 24 11 20
19 11 21 25 25 22 11 21 25 25 25 25 25 25 25 25 22 11 27 28 11 21 25 25 25 25 25 25 25 25 22 11 23 24 11 21 22 11 23 24 11 21 25 25 25 25 25 25 25 22 11 21 25 25 25 22 11 20
19 12 11 11 11 11 11 11 11 11 11 11 11 11 11 11 11 11 27 28 11 11 11 11 11 11 11 11 11 11 11 11 27 28 11 10 10 11 27 28 11 11 11 11 11 11 11 11 11 11 11 11 11 11 11 11 12 20
13 17 17 17 17 17 17 17 17 17 17 17 17 17 17 17 17 17 39 40 17 17 17 17 17 17 17 17 17 17 17 17 39 40 17 17 17 17 39 40 17 17 17 17 17 17 17 17 17 17 17 17 17 17 17 17 17 14
10 10 10 10 10 10 10 10 10 10 10 10 10 10 10 10 10 10 10 10 10 10 10 10 10 10 10 10 10 10 10 10 10 10 10 10 10 10 10 10 10 10 10 10 10 10 10 10 10 10 10 10 10 10 10 10 10 10
10 10 10 10 10 10 10 10 10 10 10 10 10 10 10 10 10 10 10 10 10 10 10 10 10 10 10 10 10 10 10 10 10 10 10 10 10 10 10 10 10 10 10 10 10 10 10 10 10 10 10 10 10 10 10 10 10 10